3,10,2,2,14,3,6,3,10,6
9,14,5,13,11,12,9,12,3,12
3,6,5,3,10,6,3,10,12,7
5,9,12,9,6,9,12,3,10,4
1,10,2,14,5,7,3,8,6,5
5,7,9,6,5,5,5,3,12,5
5,9,6,9,12,9,12,5,7,5
9,10,4,11,10,2,10,12,1,12
3,10,12,3,6,5,3,6,9,6
9,10,10,12,9,12,13,9,10,12
