3,10,10,14,7,11,10,10,10,6
5,11,10,10,0,2,10,2,14,5
5,3,10,2,4,5,11,0,14,5
5,5,7,13,5,5,11,0,14,13
13,13,9,2,12,13,11,4,3,14
11,6,3,4,3,2,2,8,4,7
7,9,4,13,13,5,13,7,5,5
5,11,12,7,7,5,11,0,4,5
5,11,10,8,8,0,14,13,13,5
9,10,10,10,14,13,11,10,10,12
