3,10,10,14,7,11,10,10,10,6
5,3,6,11,0,6,11,2,14,5
5,5,9,6,5,9,6,9,6,5
5,5,7,5,5,3,12,3,4,13
13,5,5,9,12,5,3,12,1,14
11,12,1,6,3,12,5,3,12,7
7,7,5,9,12,3,12,9,6,5
5,5,5,3,6,5,3,14,5,5
5,9,8,12,9,4,9,10,12,5
9,10,10,10,14,13,11,10,10,12
