3,10,10,14,7,11,10,10,10,6
5,3,14,3,12,7,3,10,14,5
5,1,2,4,7,5,5,11,6,5
5,13,13,1,8,0,8,10,12,13
13,3,2,12,11,8,2,2,10,14
11,4,1,2,2,14,13,9,6,7
7,13,13,5,9,6,7,3,12,5
5,11,2,8,14,5,9,0,6,5
5,11,8,10,14,1,14,13,13,5
9,10,10,10,14,13,11,10,10,12
