3,10,10,14,7,11,10,10,10,6
5,3,14,3,8,6,3,10,6,5
5,1,6,1,14,9,8,14,5,5
5,5,9,12,3,6,3,10,12,13
13,5,7,11,12,5,5,11,2,14
11,8,4,3,14,9,12,3,4,7
7,3,12,9,10,10,10,4,5,5
5,5,3,6,3,10,10,12,5,5
5,9,12,9,12,3,10,10,12,5
9,10,10,10,14,13,11,10,10,12
