3,10,10,14,7,11,10,10,10,6
5,11,2,2,12,3,2,10,14,5
5,3,12,5,3,12,9,10,6,5
5,5,11,12,9,10,10,6,5,13
13,1,10,10,10,10,10,12,1,14
11,12,3,2,10,10,10,6,5,7
7,3,12,13,3,6,11,8,12,5
5,1,10,10,12,9,10,10,6,5
5,9,14,11,10,2,10,10,12,5
9,10,10,10,14,13,11,10,10,12
