3,10,10,14,7,11,10,10,10,6
5,7,3,2,8,14,3,10,6,5
5,1,12,9,10,2,12,3,12,5
5,5,11,10,6,13,3,12,7,13
13,5,11,6,5,3,12,3,0,14
11,4,3,4,9,12,11,4,5,7
7,9,12,9,6,3,6,13,5,5
5,3,10,10,12,5,9,6,5,5
5,9,10,10,10,4,11,8,12,5
9,10,10,10,14,13,11,10,10,12
