7,11,10,10,6,3,14,7,3,14
1,14,7,3,0,12,3,12,5,7
1,14,5,13,1,14,1,14,5,5
9,6,1,6,9,10,4,11,8,4
7,5,13,1,14,11,8,2,2,4
5,9,2,4,3,14,7,13,5,13
1,2,12,1,8,10,0,10,0,14
13,5,3,4,11,10,8,14,1,6
3,4,5,13,11,2,10,10,4,5
13,13,13,11,10,12,11,10,12,13
