3,10,10,14,7,11,10,10,10,6
5,3,14,3,8,14,3,14,7,5
5,5,7,9,2,10,0,14,5,5
5,5,5,7,5,11,0,10,12,13
13,9,4,5,1,14,5,11,2,14
11,6,9,4,1,14,13,3,12,7
7,9,10,8,0,14,11,4,7,5
5,7,7,3,0,10,2,0,4,5
5,9,8,12,9,6,13,13,13,5
9,10,10,10,14,13,11,10,10,12
