3,10,10,14,7,11,10,10,10,6
5,7,7,11,4,7,7,7,7,5
5,5,9,6,1,8,12,9,4,5
5,9,6,9,8,2,10,14,5,13
13,7,9,6,7,5,3,10,8,14
11,0,6,1,12,1,8,2,14,7
7,13,1,8,10,4,7,9,14,5
5,3,4,7,3,0,0,6,7,5
5,13,13,9,12,5,13,9,12,5
9,10,10,10,14,13,11,10,10,12
